----------
----------
---O------
---OOO----
---OOOO---
----------
----------
----------
